1111111111111111111111111111111111
1000000000000000C00000C00000X00001
1001000011111111111100000000100001
1000000011111111111100E00000000001
1P0000000000C000X00000000000010001
1000000011111111111100000000000001
1001000011111111111100000000000001
1000000011110001111101000010000001
10000000111101011111000000000X0011
1000000011110001111101000000000011
1000010011111111111100000000000001
1000000011111111111101000000000011
1000000000000000000000000110000001
1111111111111111111111111111111111